#########
#...#...#
#...#...#
#+#|#|#+#
.........
xxx...xxx
