xx....xx
x......x
........
...##...
...##...
........
x......x
xx....xx
